5 5 5 5 5 2 2 2 2 2 2 2 2 2 5 5 5 5 5 5
1 1 0 0 0 0 0 0 0 0 0 0 0 0 0 0 0 0 8 8
1 1 0 0 0 0 0 0 0 0 0 0 0 0 0 0 0 0 8 8
1 1 0 0 0 0 0 0 0 0 0 0 0 0 0 0 0 0 8 8
1 1 0 0 0 0 0 0 0 0 0 0 0 0 0 0 0 0 8 8
1 1 0 0 0 0 0 0 0 0 0 0 0 0 0 0 0 0 8 8
1 1 0 0 0 0 0 2 2 2 2 2 0 0 0 0 0 0 8 8
1 1 0 0 0 0 0 2 2 2 2 2 0 0 0 0 0 0 8 8
1 1 0 0 0 0 0 2 2 2 2 2 0 0 0 0 0 0 8 8
1 1 0 0 0 0 0 2 2 2 2 2 0 0 0 0 0 0 8 8
1 1 0 0 0 0 0 2 2 2 2 2 0 0 0 0 0 0 8 8
1 1 0 0 0 0 0 0 0 0 0 0 0 0 0 0 0 0 8 8
1 0 0 0 0 0 0 0 0 0 0 0 0 0 0 0 0 0 8 8
1 1 0 0 0 0 0 0 0 0 0 0 0 0 0 0 0 0 8 8
1 1 4 0 0 0 0 0 0 0 0 0 0 0 0 0 0 0 8 8
1 1 3 6 6 6 6 6 6 6 6 6 6 6 6 6 6 6 8 8