5 5 5 5 5 2 2 2 2 2 2 2 2 2 5 5 5 5 5 5
1 0 6 0 0 0 0 0 0 0 0 0 0 0 0 0 0 8 0 1
1 0 6 0 0 0 0 0 0 0 0 0 0 0 0 0 0 8 0 1
1 0 6 0 7 7 7 7 7 7 7 7 7 7 7 7 0 8 0 1
1 0 6 0 7 0 0 0 0 0 0 0 0 0 0 7 0 8 0 1
1 0 6 0 7 0 0 0 0 0 0 0 0 0 0 7 0 8 0 1
1 0 6 0 7 0 7 7 7 7 7 7 7 7 0 7 0 8 0 1
1 0 0 0 0 0 0 0 0 7 7 0 0 0 0 0 0 0 0 1
1 0 6 6 0 6 6 6 0 7 7 0 8 8 8 0 8 8 0 1
1 0 0 6 0 0 0 0 0 0 0 0 0 0 0 0 8 0 0 1
1 0 0 6 0 6 0 0 0 7 7 0 0 0 8 0 8 0 0 1
1 1 0 6 0 6 0 0 0 7 7 0 0 0 8 0 8 0 1 1
1 0 0 0 0 6 0 0 0 7 7 0 0 0 8 0 0 0 0 1
1 0 6 6 6 6 6 6 0 7 7 0 8 8 8 8 8 8 0 1
1 0 4 0 0 0 0 0 0 0 0 0 0 0 0 0 0 0 0 1
1 1 3 1 1 1 1 1 1 1 1 1 1 1 1 1 1 1 1 1