5 5 5 5 5 2 2 2 2 2 2 2 2 2 5 5 5 5 5 5
1 1 0 1 0 0 0 1 0 0 0 0 0 1 0 0 0 0 1 1
1 1 0 0 0 1 0 0 0 0 1 1 0 0 0 1 1 1 1 1
1 1 0 1 1 1 1 1 1 1 1 1 1 1 1 1 1 1 1 1
1 1 0 1 7 7 7 7 7 7 7 7 7 7 7 7 7 7 1 1
1 1 0 1 1 1 1 1 1 1 1 1 1 1 1 1 1 1 1 1
1 1 0 0 0 0 0 0 0 0 0 0 0 0 0 0 0 0 1 1
1 1 0 6 6 6 6 6 6 6 6 6 6 6 6 6 0 0 1 1
1 1 0 6 0 0 0 0 0 0 0 0 0 0 0 0 0 0 1 1
1 1 0 6 6 6 6 6 6 6 6 6 6 6 6 6 6 6 6 1
1 1 0 0 0 0 0 0 0 0 0 0 0 0 0 0 0 0 6 1
1 1 0 8 8 0 8 8 7 7 0 7 7 7 0 7 7 0 6 1
1 1 0 8 0 0 0 8 7 0 0 0 7 0 0 0 7 0 6 1
1 1 0 8 0 0 0 8 7 0 0 0 7 0 0 0 7 0 6 1
1 1 4 8 0 0 0 8 7 0 0 0 7 0 0 0 7 0 6 1
1 1 3 8 8 8 8 8 7 7 7 7 7 7 7 7 7 6 6 1 1